R 640 480 

NO ./textures/Gold1.xpm
SO ./textures/Gold0.xpm
WE ./textures/GemOv1.xpm
EA ./textures/TreeRings.xpm    

S ./textures/barrel.xpm           
S2 ./textures/guard.xpm
S3 ./textures/cage.xpm
S4 ./textures/spear.xpm

F 100,30,22
C 23,32,42

111111111111111111111111111
   100000000000010000000000111
   100000000000010000000011111
1111000000000010000000100011
100000000000010000000100011
111111111111000000000155511
100000000003000000000000      11
1000000000030000000001030     11
111111111111000000000140011
100000000000000100000100211
100000000000000100000100011
10000000000000010000010N011
100000000000000100000100011
111111111111111111111111111
