SO ./textures/Gold0.xpm
WE ./textures/GemOv1.xpm
EA ./textures/TreeRings.xpm    

NO ./textures/Gold1.xpm




R 960 720 

S ./textures/barrel.xpm           
S2 ./textures/guard.xpm
S3 ./textures/cage.xpm
S4 ./textures/spear.xpm




F 100,30,22
C 23,32,42

      1111111111111111111111111111
      1000000000110000000000001111
      1011000001110000002000001111
      1001000000000000000000011111
11111111011000001110000000001
10200000011000001110000000011
110000000000000000000000000001
11103001101010111000000103011
10000000040000201100000010000111
1100E000000030001101010010000001
11000011101010111101100000011111 
100000111111010110111010011   
111111111111111111111111111
