  SO ./textures/Gold0.xpm
WE ./textures/GemOv1.xpm
EA ./textures/TreeRings.xpm    

NO ./textures/Gold1.xpm




  R 640 480

S ./textures/barrel.xpm           
S2 ./textures/guard.xpm
S3 ./textures/cage.xpm
S4 ./textures/spear.xpm

F 100,30,22
C 23,32,42

  111111111111111111111111
110000000011000000000001
101100000111000000000001
10010 000000000000000001
101100001110000000000001
100000000011000001110111
111101111111111111000001
111101111010101011010101
110000001100010111000001
100000000000000011000001
100000000000000011010101
110000001101010111110111
111101111111011111110111
111101111111001011000001
110000011100000011000001
100000001102220011000001
100000001000200011100011
100000000050040110010101
110000010003000010100011
10000000100000110000000011111
10000000000000000000000000001
10000000100N00000000000000001
11000001110001101000000011111
111111111111111111111111
