  SO ./textures/Bricks.xpm
WE ./textures/redbrick.xpm
EA ./textures/Ice.xpm    

NO ./textures/LavaF1.xpm




  R 960 720

S ./textures/barrel.xpm           
S2 ./textures/guard.xpm
S3 ./textures/cage.xpm
S4 ./textures/spear.xpm

F 95,0,146
C 23,32,42

    111111111111111111111111
1111100000000000000000000001
100S000000000000011000000001
1000000000100000000000010001
1000000400 000000 0002000001
10000004000000000000000000001111
10020030000000000000000000000001
 1000000000000000000000000000001
 1000000 00000000000000000001111
10000000000000000000000000000001
11111111111111111111111111111111
